        NO      rgvgr        

F 00,11,22
C 00,11,22
EA FVRT
WE ETFGRF
SO RF4

11   11111  11    
11110S0110011  
      1110010001110011    
111111111111
