NO rgvgr
EA FVRT
F 00,11,22
C 00,11,22
WE ETFGRF
SO ff

11111111111
10000000001
10001110001
10001 10001
10001 10001
10001110001
1000000001
10N000001111
11111111111

