NO aa.png
F 107,78,50
C 140,196,252
EA bb.png
WE lll.png
SO ff.png

1111111111111
11111111
1011W11011
1111111111