        NO      rgvgr        

F 00,11,22
C 00,11,22
EA FVRT
WE ETFGRF
SO RF4

11 1111 11
11 111111111111111
   1N01111S011
111111111111
